   ***
****S****
*       *
*       *
***   ***
*       *
*       *
******E**
     ***
